1 1 h 1 1 0 0 0 0 0
0 k 1 1 1 k 0 0 0 0
0 0 0 0 0 1 0 0 0 0
1 1 k 1 1 1 k 1 0 0
1 0 0 0 0 1 s 1 1 d
g 1 1 1 0 0 0 1 0 0
1 k s s 0 0 0 c 0 0
0 0 0 0 0 0 1 0 0 0
0 0 0 0 0 0 1 0 0 0
0 0 0 0 0 0 1 0 0 0